1,1,1,1,1,1,1,1,1,1,1,1,1,1,1,1,1
1,0,0,0,1,0,0,0,0,0,1,0,0,0,0,1,1
1,0,1,0,0,0,1,1,1,0,0,0,1,1,0,0,1
1,0,0,1,1,0,1,0,0,0,1,0,1,1,1,1,1
1,1,0,1,1,0,0,1,1,1,0,0,1,0,1,finish,1
1,0,0,0,0,1,0,0,0,0,1,1,1,0,1,0,1
1,0,1,1,1,1,1,0,1,1,1,0,0,0,1,0,1
1,0,0,1,0,0,1,0,0,0,1,0,1,1,0,0,1
1,0,1,1,1,0,1,1,1,0,0,0,0,0,0,1,1
1,0,0,0,1,0,1,1,1,1,1,0,1,1,1,1,1
1,1,1,0,1,0,1,0,0,0,1,0,1,0,0,0,1
1,0,1,0,1,0,1,1,1,0,1,1,1,0,1,1,1
1,0,0,0,1,0,0,0,0,0,1,0,0,0,0,0,1
1,1,0,1,1,0,1,1,1,0,1,1,1,0,1,0,1
1,1,0,0,0,0,0,0,1,0,0,0,0,0,1,1,1
1,1,0,1,1,start,1,0,0,0,1,1,1,0,0,0,1
1,1,1,1,1,1,1,1,1,1,1,1,1,1,1,1,1
